{

"fg" : [
[1,1,1,1,1,1,1,1,1,1,1,1,1,1,1,1],
[1,1,1,0,0,0,0,0,0,0,0,0,0,0,1,1],
[1,1,0,0,0,0,0,0,0,0,0,0,0,0,0,1],
[1,1,0,0,0,0,0,0,0,0,0,0,0,0,0,1],
[1,1,0,0,0,0,0,0,0,0,0,0,0,0,0,1],
[0,0,0,0,0,0,0,0,0,0,0,0,0,0,0,1],
[0,0,0,0,0,0,0,0,0,0,0,0,0,0,0,1],
[0,0,0,0,0,0,0,0,0,0,0,0,0,0,0,1],
[0,0,0,0,0,0,0,0,0,0,0,0,0,0,0,1],
[0,0,0,0,0,0,0,0,0,0,0,0,0,0,0,1],
[0,0,0,0,0,0,0,0,0,0,0,0,0,0,0,1],
[0,0,0,0,0,0,0,0,0,0,0,0,0,0,0,1],
[1,1,1,1,0,0,0,0,0,0,0,0,0,0,0,1],
[1,1,1,1,1,0,0,0,0,0,0,0,0,0,0,1],
[1,1,1,1,1,1,0,0,0,0,0,0,0,0,1,1],
[1,1,1,1,1,1,1,0,0,1,1,1,1,1,1,1]],

"bg" : [
[0,0,0,0,0,0,0,0,0,0,0,0,0,0,0,0],
[0,0,0,0,0,0,0,0,0,0,0,0,0,0,0,0],
[0,0,0,0,0,0,0,0,0,0,0,0,0,0,0,0],
[0,0,0,0,0,0,0,0,0,0,0,0,0,0,0,0],
[0,0,0,0,0,0,0,0,0,0,0,0,0,0,0,0],
[0,0,0,0,0,0,0,0,0,0,0,0,0,0,0,0],
[0,0,0,0,0,0,0,0,0,0,0,0,0,0,0,0],
[0,0,0,0,0,0,0,0,0,0,0,0,0,0,0,0],
[1,1,1,1,0,0,0,0,0,0,0,0,0,0,0,0],
[0,0,0,0,1,0,0,0,0,0,0,0,0,0,0,0],
[0,0,0,0,0,1,0,0,0,0,0,0,0,0,1,0],
[0,0,0,0,0,0,1,0,0,1,1,1,1,1,0,0],
[0,0,0,0,0,0,0,0,0,0,0,0,0,0,0,0],
[0,0,0,0,0,0,0,0,0,0,0,0,0,0,0,0],
[0,0,0,0,0,0,0,0,0,0,0,0,0,0,0,0],
[0,0,0,0,0,0,0,0,0,0,0,0,0,0,0,0]],

"gd" : [
[0,0,0,0,0,0,0,0,0,0,0,0,0,0,0,0],
[0,1,1,1,1,1,1,1,1,1,1,1,1,1,1,0],
[0,1,1,1,1,1,1,1,1,1,1,1,1,1,1,0],
[0,1,1,1,1,1,1,1,1,1,1,1,1,1,1,0],
[1,1,1,1,1,1,1,1,1,1,1,1,1,1,1,0],
[1,1,1,1,1,1,1,1,1,1,1,1,1,1,1,0],
[1,1,1,1,1,1,1,1,1,1,1,1,1,1,1,0],
[1,1,1,1,1,1,1,1,1,1,1,1,1,1,1,0],
[1,1,1,1,1,1,1,1,1,1,1,1,1,1,1,0],
[0,1,1,1,1,1,1,1,1,1,1,1,1,1,1,0],
[0,1,1,1,1,1,1,1,1,1,1,1,1,1,1,0],
[0,1,1,1,1,1,1,1,1,1,1,1,1,1,1,0],
[0,1,1,1,1,1,1,1,1,1,1,1,1,1,1,0],
[0,0,0,0,0,0,0,1,1,0,0,0,0,0,0,0],
[0,0,0,0,0,0,0,1,1,0,0,0,0,0,0,0],
[0,0,0,0,0,0,0,1,1,0,0,0,0,0,0,0]],

"emplacements":{
"enemy" : [{"x":0.33,"y":-2.14},
{"x":1.95,"y":0.73}],
"zone8x7" : [{"x":-2,"y":-3}],
"zone4x1" : [{"x":1,"y":1}]}

}