{

"fg" : [
[1,1,1,1,1,1,1,0,0,1,1,1,1,1,1,1],
[1,1,0,0,0,0,0,0,0,0,0,0,0,0,1,1],
[1,0,0,0,0,0,0,0,0,0,0,0,0,0,0,1],
[1,0,0,0,0,0,0,0,0,0,0,0,0,0,0,1],
[1,0,0,0,0,0,0,0,0,0,0,0,0,0,0,1],
[1,0,0,0,0,0,0,0,0,0,0,0,0,0,0,0],
[1,0,0,0,0,0,0,0,0,0,0,0,0,0,0,0],
[1,0,0,0,0,0,0,0,0,0,0,0,0,0,0,0],
[1,0,0,0,0,0,0,0,0,0,0,0,0,0,0,0],
[1,1,1,1,1,0,0,0,0,0,0,0,0,0,0,0],
[1,1,0,0,1,1,1,1,0,0,0,0,0,0,0,0],
[1,0,0,0,0,0,0,0,0,0,0,0,0,0,0,0],
[1,0,0,0,0,0,0,0,0,0,0,0,0,0,0,1],
[1,0,0,0,0,0,0,0,0,0,0,0,0,0,0,1],
[1,0,0,0,0,0,0,0,0,0,0,0,0,0,0,1],
[1,1,1,0,0,0,0,0,0,0,0,0,0,1,1,1]],

"bg" : [
[0,0,0,0,0,0,0,0,0,0,0,0,0,0,0,0],
[0,0,0,0,0,0,0,0,0,0,0,0,0,0,0,0],
[0,0,0,0,0,0,0,0,0,0,0,0,0,0,0,0],
[0,0,0,0,0,0,0,0,0,0,0,0,0,0,0,0],
[0,0,0,0,0,0,0,0,0,0,0,0,0,0,0,0],
[1,1,1,1,1,0,0,0,0,0,0,0,0,0,0,0],
[0,0,0,0,0,1,1,1,0,0,0,0,0,0,0,0],
[0,0,0,0,0,0,0,0,0,0,0,0,0,0,0,0],
[0,0,0,0,0,0,0,0,0,0,0,0,0,0,0,1],
[0,0,0,0,0,0,0,0,0,0,0,0,0,0,0,0],
[0,0,0,0,0,0,0,0,0,0,0,0,0,0,0,0],
[0,1,0,0,0,0,0,0,0,0,0,0,0,0,1,0],
[0,0,1,1,1,1,1,1,1,1,1,1,1,1,0,0],
[0,0,0,0,0,0,0,0,0,0,0,0,0,0,0,0],
[0,0,0,0,0,0,0,0,0,0,0,0,0,0,0,0],
[0,0,0,0,0,0,0,0,0,0,0,0,0,0,0,0]],

"gd" : [
[0,0,0,0,0,0,1,1,1,1,0,0,0,0,0,0],
[0,1,1,1,1,1,1,1,1,1,1,1,1,1,1,0],
[0,1,1,1,1,1,1,1,1,1,1,1,1,1,1,0],
[0,1,1,1,1,1,1,1,1,1,1,1,1,1,1,0],
[0,1,1,1,1,1,1,1,1,1,1,1,1,1,1,1],
[0,1,1,1,1,1,1,1,1,1,1,1,1,1,1,1],
[0,1,1,1,1,1,1,1,1,1,1,1,1,1,1,1],
[0,1,1,1,1,1,1,1,1,1,1,1,1,1,1,1],
[0,1,1,1,1,1,1,1,1,1,1,1,1,1,1,1],
[0,1,1,1,1,1,1,1,1,1,1,1,1,1,1,0],
[0,1,1,1,1,1,1,1,1,1,1,1,1,1,1,0],
[0,1,1,1,1,1,1,1,1,1,1,1,1,1,1,0],
[0,1,1,1,1,1,1,1,1,1,1,1,1,1,1,0],
[0,0,0,0,0,0,0,0,0,0,0,0,0,0,0,0],
[0,0,0,0,0,0,0,1,1,0,0,0,0,0,0,0],
[0,0,0,0,0,0,0,1,1,0,0,0,0,0,0,0]],

"emplacements":{
"enemy" : [{"x":-2.18,"y":-2.69},
{"x":1.95,"y":0.41}],
"zone2x1" : [{"x":-3,"y":1.5}],
"zone4x2" : [{"x":1,"y":-3}],
"zone3x1" : [{"x":-3.5,"y":-2}]}

}