{

"fg" : [
[1,1,1,1,1,1,1,1,1,1,1,1,1,1,1,1],
[1,1,0,0,0,0,0,0,0,0,0,0,1,1,1,0],
[1,0,0,0,0,0,0,0,0,0,0,0,0,1,1,0],
[1,0,0,0,0,0,0,0,0,0,0,0,0,1,1,0],
[1,0,0,0,0,0,0,0,0,0,0,0,0,1,1,0],
[1,0,0,0,0,0,0,0,0,0,0,0,0,1,1,0],
[1,0,0,0,0,0,0,0,0,0,0,0,0,1,1,0],
[1,0,0,0,0,0,1,1,1,1,0,0,1,1,1,0],
[1,0,0,0,0,0,0,0,0,1,1,1,1,1,1,0],
[1,0,0,0,0,0,0,0,0,0,0,0,0,0,0,0],
[1,0,0,0,0,0,0,0,0,0,0,0,0,0,0,0],
[1,0,0,0,0,0,0,0,0,0,0,0,0,0,0,0],
[1,0,0,0,0,0,0,0,0,0,0,0,0,0,0,0],
[1,0,0,0,0,0,1,1,1,0,0,0,0,0,0,0],
[1,0,0,0,0,0,1,1,1,0,0,0,0,0,0,0],
[1,1,1,0,1,1,1,1,1,1,1,0,0,1,1,1]],

"bg" : [
[0,0,0,0,0,0,0,0,0,0,0,0,0,0,0,0],
[0,0,0,0,0,0,0,0,0,0,0,0,0,0,0,0],
[0,0,0,0,0,0,0,0,0,0,0,0,0,0,0,0],
[0,0,0,0,0,0,1,1,1,1,0,0,1,0,0,0],
[0,0,0,0,0,0,0,0,0,0,1,1,0,0,0,0],
[0,0,0,0,0,0,0,0,0,0,0,0,0,0,0,0],
[0,0,0,0,0,0,0,0,0,0,0,0,0,0,0,0],
[0,0,0,0,0,0,0,0,0,0,0,0,0,0,0,0],
[0,0,0,0,0,0,0,0,0,0,0,0,0,0,0,0],
[0,0,0,0,0,0,1,1,1,0,0,0,0,0,0,0],
[0,0,0,0,0,0,0,0,0,0,0,0,0,0,0,0],
[0,1,0,0,0,1,0,0,0,1,0,0,0,0,1,1],
[0,0,1,1,1,0,0,0,0,0,1,1,1,1,0,0],
[0,0,0,0,0,0,0,0,0,0,0,0,0,0,0,0],
[0,0,0,0,0,0,0,0,0,0,0,0,0,0,0,0],
[0,0,0,0,0,0,0,0,0,0,0,0,0,0,0,0]],

"gd" : [
[0,0,0,0,0,0,1,1,1,1,0,0,0,0,0,1],
[0,1,1,1,1,1,1,1,1,1,1,1,1,1,1,1],
[0,1,1,1,1,1,1,1,1,1,1,1,1,1,1,1],
[0,1,1,1,1,1,1,1,1,1,1,1,1,1,1,1],
[0,1,1,1,1,1,1,1,1,1,1,1,1,1,1,1],
[0,1,1,1,1,1,1,1,1,1,1,1,1,1,1,1],
[0,1,1,1,1,1,1,1,1,1,1,1,1,1,1,1],
[0,1,1,1,1,1,1,1,1,1,1,1,1,1,1,1],
[0,1,1,1,1,1,1,1,1,1,1,1,1,1,1,1],
[0,1,1,1,1,1,1,1,1,1,1,1,1,1,1,1],
[0,1,1,1,1,1,1,1,1,1,1,1,1,1,1,1],
[0,1,1,1,1,1,1,1,1,1,1,1,1,1,1,1],
[0,1,1,1,1,1,1,1,1,1,1,1,1,1,1,1],
[0,0,0,0,0,0,0,0,0,0,0,0,0,0,0,0],
[0,0,0,0,0,0,0,1,1,0,0,0,0,0,0,0],
[0,0,0,0,0,0,0,1,1,0,0,0,0,0,0,0]],

"emplacements":{
"enemy" : [{"x":1.95,"y":0.9400001}],
"interactive" : [{"x":-2.25,"y":1.5},
{"x":1.5,"y":-2.5}]}

}